1111111111111
1001000100C01
1CCCCC001CE01
1P101100C0001
1111111111111