1111111111111111111
1P10100001000100001
101000000C000C00011
100000C0000000C0001
1E0010C0C1000000001
1111111111111111111