11111111111
11110C00C11
1111I00I011
11110I01111
10000000001
1C0I0P0I0E1
10000000001
11110I01111
11110001111
11110001111
11111111111