1111111111111111111
1PC000I000II0000001
10000C00C0000II0C01
10000C00C0000II0C01
10000C00C0000II0C01
1C00CI0C00C00II0E01
1111111111111111111
